XXXXX
X H X
X X X
X X X
X   X
X X X 
X X X
X X X  
X F X
XXXXX